Gears of War 2	9.3	Epic Games	Microsoft Game Studios
Forza Motorsport 3	9.2	Turn 10	Microsoft Game Studios
Halo: Reach	9.1	Bungie	Microsoft Game Studios
Gears of War 3	9.1	Epic Games	Microsoft Game Studios
Forza Motorsport 4	9.1	Turn 10	Microsoft Game Studios
Geometry Wars: Retro Evolved 2	9.0	Bizarre Creations	Bizarre Creations
Forza Motorsport 2	9.0	Turn 10	Microsoft Game Studios
Gears of War 2: All Fronts Collection	8.9	Epic Games	Microsoft Game Studios
Zeno Clash: Ultimate Edition	8.8	ACE Team	Atlus
Sega Vintage Collection: Streets of Rage	8.8	M2	Sega
Project Gotham Racing 3	8.8	Bizarre Creations	Microsoft Game Studios
Joe Danger: Special Edition	8.8	Hello Games	Microsoft Game Studios
Sonic the Hedgehog 3	8.7	Backbone Entertainment	Sega
Forza Horizon	8.7	Playground Games	Microsoft Game Studios
Trials HD	8.6	RedLynx	Microsoft Game Studios
Sonic & Knuckles	8.6	Sonic Team	Sega
Dance Central 3	8.6	Harmonix Music Systems	Microsoft Game Studios
Dance Central 2	8.6	Harmonix Music Systems	Microsoft Game Studios
Trials Evolution: Origin of Pain	8.5	RedLynx	Microsoft Game Studios
Toy Soldiers: Cold War	8.5	Signal Studios	Microsoft Game Studios
Project Gotham Racing 4	8.5	Bizarre Creations	Microsoft Game Studios
Gears of War 3: Forces of Nature Map Pack	8.5	Epic Games	Microsoft Game Studios
Dead or Alive 4	8.5	Team Ninja	Tecmo
Viva Pinata: Trouble in Paradise	8.4	Rare Ltd.	Microsoft Game Studios
'Splosion Man	8.4	Twisted Pixel Games	Twisted Pixel Games
Lost Odyssey	8.4	Mistwalker	Microsoft Game Studios
Bomberman Live	8.4	Backbone Entertainment	Hudson Entertainment
ilomilo	8.3	Southend Interactive	Microsoft Game Studios
Halo 3: ODST	8.3	Bungie	Microsoft Game Studios
Crackdown	8.3	Realtime Worlds	Microsoft Game Studios
Smash T.V.	8.2	Digital Eclipse	Midway
Raiden IV	8.2	Moss	UFO Interactive
Halo Wars	8.2	Ensemble Studios	Microsoft Game Studios
Dance Central (2010)	8.2	Harmonix Music Systems	MTV Games
Your Shape: Fitness Evolved	8.1	Ubisoft Montreal	Ubisoft
Trials Evolution: The Riders of Doom	8.1	RedLynx	Microsoft Game Studios
The Gunstringer	8.1	Twisted Pixel Games	Twisted Pixel Games
Ridge Racer 6	8.1	Namco	Namco
Perfect Dark Zero	8.1	Rare Ltd.	Microsoft Game Studios
Ninja Gaiden II	8.1	Team Ninja	Tecmo
Kinect Party	8.1	Double Fine Productions	Microsoft Game Studios
Import Tuner Challenge	8.1	Genki	Ubisoft
Halo: Reach - Defiant Map Pack	8.1	Bungie	Microsoft Game Studios
Snoopy Flying Ace	8.0	Smart Bomb Interactive	Microsoft Game Studios
MotoGP '06	8.0	Climax Studios	THQ
Marble Blast Ultra	8.0	GarageGames	GarageGames
Half-Minute Hero: Super Mega Neo Climax	8.0	Opus	Microsoft Game Studios
Guwange	8.0	Cave	Cave
Gears of War 3: RAAM's Shadow	8.0	Epic Games	Microsoft Game Studios
Double Fine Happy Action Theater	8.0	Double Fine Productions	Microsoft Game Studios
Alan Wake: The Writer	8.0	Remedy Entertainment	Microsoft Game Studios
Ace Combat 6: Fires of Liberation	8.0	Project Aces 	Namco Bandai Games
Sesame Street: Once Upon a Monster	7.9	Double Fine Productions	Warner Bros. Interactive Entertainment
Quarrel	7.9	Denki	UTV Ignition Games
Naruto: Rise of a Ninja	7.9	Ubisoft Montreal	Ubisoft
Joy Ride Turbo	7.9	BigPark	Microsoft Game Studios
Hexic HD	7.9	Carbonated Games	Microsoft Game Studios
Gears of War: Judgment	7.9	Epic Games	Microsoft Game Studios
Dead Rising 2: Case Zero	7.9	Blue Castle Games	Capcom
Raiden Fighters Aces	7.8	Gulti	Valcon Games
Project Sylpheed: Arc of Deception	7.8	Game Arts	Square Enix
Motocross Madness (2013)	7.8	Bongfish	Microsoft Game Studios
Kinectimals: Now with Bears!	7.8	Frontier Developments	Microsoft Game Studios
Far Cry Instincts Predator	7.8	Ubisoft Montreal	Ubisoft
Fable II: Knothole Island	7.8	Lionhead Studios	Microsoft Game Studios
Every Extend Extra Extreme	7.8	Cyclone Zero	Q Entertainment
Bangai-O HD: Missile Fury	7.8	Treasure	D3Publisher
Your Shape Fitness Evolved 2012	7.7	Ubisoft	Ubisoft
Uno Rush	7.7	Carbonated Games	Microsoft Game Studios
The Outfit	7.7	Relic Entertainment	THQ
Tenchu Z	7.7	K2 LLC	Microsoft Game Studios
Spectral Force 3	7.7	Xpec	Atlus
Rise of Nightmares	7.7	Sega	Sega
Red Bull Crashed Ice Kinect	7.7	Bongfish	Microsoft Game Studios
Otomedius Excellent	7.7	Konami	Konami
Kung-Fu High Impact	7.7	Virtual Air Guitar Company	UTV Ignition Games
Kinect Sports	7.7	Rare Ltd.	Microsoft Game Studios
Haunt (2012)	7.7	NanaOn-Sha	Microsoft Game Studios
Full House Poker	7.7	Microsoft Game Studios	Microsoft Game Studios
Yu-Gi-Oh! 5D's Decade Duels	7.6	Konami	Konami
Undertow	7.6	Chair Entertainment	Chair Entertainment
Tomb Raider Underworld: Lara's Shadow	7.6	Crystal Dynamics	Eidos Interactive
Street Fighter II' Hyper Fighting	7.6	Sensory Sweep	Capcom
Scene It? Box Office Smash	7.6	Screenlife Games	Microsoft Game Studios
Kinect Sesame Street TV	7.6	Microsoft Studios - Soho Productions	Microsoft Game Studios
Forza Horizon: Rally Expansion Pack	7.6	Playground Games	Microsoft Game Studios
F.E.A.R. Files	7.6	TimeGate Studios	Sierra Entertainment
The Dishwasher: Dead Samurai	7.5	Ska Studios	Microsoft Game Studios
South Park: Tenorman's Revenge	7.5	Other Ocean Interactive	Other Ocean Interactive
Race Pro	7.5	SimBin	Atari SA
Panzer General: Allied Assault	7.5	Petroglyph	Ubisoft
N3II: Ninety-Nine Nights	7.5	FeelPlus	Konami
Gears of War 3: Fenix Rising Map Pack	7.5	Epic Games	Microsoft Game Studios
Full Auto	7.5	Pseudo Interactive	Sega
Dungeon Fighter LIVE: Fall of Hendon Myre	7.5	Nexon	Microsoft Game Studios
Dead or Alive Xtreme 2	7.5	Team Ninja	Tecmo
Culdcept SAGA	7.5	Omiya Soft	Namco Bandai Games
Bejeweled Blitz Live	7.5	Torpex Games LLC	PopCap
Assault Heroes 2	7.5	Wanako Studios	Sierra Online
Alan Wake: The Signal	7.5	Remedy Entertainment	Microsoft Game Studios
Nike+ Kinect Training	7.4	Nike, Inc.	Microsoft Game Studios
Infinite Undiscovery	7.4	Tri-Ace	Square Enix
Doritos Crash Course	7.4	Wanako Studios	Microsoft Game Studios
Dead Rising 2: Case West	7.4	Blue Castle Games	Capcom
Comic Jumper: The Adventures of Captain Smiley	7.4	Twisted Pixel Games	Twisted Pixel Games
Amped 3	7.4	2K Sports	2K Sports
Zumba Fitness Rush	7.3	Zoe Mode	Majesco
Small Arms	7.3	Gastronaut Studios	Gastronaut Studios
Scene It? Lights, Camera, Action	7.3	Screenlife Games	Microsoft Game Studios
NBA Baller Beats	7.3	HB Studios Multimedia	Majesco
Jetpac Refuelled	7.3	Rare Ltd.	Microsoft Game Studios
Islands of Wakfu	7.3	Ankama Games	Microsoft Game Studios
Bloodforge	7.3	Climax Studios	Microsoft Game Studios
Beautiful Katamari	7.3	Now Production	Namco Bandai Games
Hexic 2	7.2	Carbonated Games	Microsoft Game Studios
Crimson Alliance	7.2	Certain Affinity	Certain Affinity
Hydrophobia	7.1	Dark Energy Digital	Microsoft Game Studios
Fruit Ninja Kinect	7.1	Halfbrick Studios	Microsoft Game Studios
Chromehounds	7.1	From Software	Sega
Trouble Witches Neo!	7.0	Adventure Planning Service	SNK Playmore
Lips: Number One Hits	7.0	iNiS	Microsoft Game Studios
Kinect Sports: Season Two	7.0	BigPark	Microsoft Game Studios
Crackdown 2	7.0	Ruffian Games	Microsoft Game Studios
Viva Pinata: Party Animals	6.9	Krome Studios	Microsoft Game Studios
Quake Arena Arcade	6.9	id Software	Bethesda Softworks
PowerUp Heroes	6.9	Ubisoft	Ubisoft
Magna Carta 2	6.9	SoftMax	Namco Bandai Games
Stoked	6.8	Bongfish	Destineer
Ninety-Nine Nights	6.8	Q Entertainment	Microsoft Game Studios
Wreckateer	6.7	Iron Galaxy Studios	Microsoft Game Studios
Rumble Roses XX	6.7	Konami	Konami
Operation Darkness	6.7	Success	Atlus
Warhammer: Battle March	6.5	Black Hole Games	Namco Bandai Games
Harms Way	6.5	Bongfish	Bongfish
Fable II: See the Future	6.5	Lionhead Studios	Microsoft Game Studios
Capcom Digital Collection	6.5	Capcom	Capcom
Bankshot Billiards 2	6.5	PixelStorm	PixelStorm
Fuzion Frenzy 2	6.4	Hudson Soft	Microsoft Game Studios
Aegis Wing	6.4	Carbonated Games	Microsoft Game Studios
Texas Hold 'Em	6.3	TikGames	TikGames
Namco Museum: Virtual Arcade	6.3	Namco Bandai Games	Namco Bandai Games
Kinect Adventures!	6.3	Good Science Studio	Microsoft Game Studios
DanceMasters	6.3	GCP1	Konami
Wipeout: In the Zone	6.2	Behaviour Interactive	Activision
Onechanbara: Bikini Samurai Squad	6.2	Tamsoft	D3Publisher
Fable: The Journey	6.1	Lionhead Studios	Microsoft Game Studios
Rabbids: Alive & Kicking	5.8	Ubisoft	Ubisoft
Doodle Jump for Kinect	5.8	Smoking Gun Interactive	D3Publisher
Arkanoid Live!	5.8	Taito Corporation	Taito Corporation
Gears of War: Judgment - Call to Arms	5.7	Epic Games	Microsoft Game Studios
Freefall Racers	5.7	Smoking Gun Interactive	Deep Silver
Body and Brain Connection	5.7	Namco Bandai Games	Namco Bandai Games
Fable II Pub Games	5.6	Lionhead Studios	Microsoft Game Studios
Don King Presents: Prizefighter	5.6	Venom Games	2K Sports
You're in the Movies	5.5	Zoe Mode	Codemasters
Kinect Star Wars	5.5	Terminal Reality	Microsoft Game Studios
Fable Heroes	5.5	Lionhead Studios	Microsoft Game Studios
Asteroids & Deluxe	5.5	Stainless Games	Atari SA
Spyglass Board Games	5.4	Strange Flavour	Microsoft Game Studios
Kinect Joy Ride	5.4	BigPark	Microsoft Game Studios
Harry Potter for Kinect	5.4	Eurocom	Warner Bros. Interactive Entertainment
Dash of Destruction	5.3	NinjaBee	Microsoft Game Studios
Samurai Shodown Sen	5.2	K2 LLC	XSEED Games
Yaris	4.9	Backbone Entertainment	Backbone Entertainment
Dragon Ball Z for Kinect	4.9	Spike Chunsoft	Namco Bandai Games
Fire Pro Wrestling	4.8	Spike Chunsoft	Microsoft Game Studios
Sonic Free Riders	4.7	Sonic Team	Sega
Hole in the Wall	4.7	Virtuos	Microsoft Game Studios
Self-Defense Training Camp	4.6	Advanced Mobile Applications Ltd.	Ubisoft
Fighters Uncaged	4.6	Ubisoft	Ubisoft
Blackwater	4.5	Zombie Studios	505 Games
TotemBall	4.4	Strange Flavour	Freeverse Software
Steel Battalion: Heavy Armor	3.8	From Software	Capcom
Bomberman Act: Zero	3.4	Hudson	Konami
Deca Sports Freedom	3.3	Hudson	Hudson Entertainment
Hulk Hogan's Main Event	2.6	Panic Button	Majesco
Zombie Wranglers	None	Frozen Codebase	Sierra Online
Zoids Assault	None	Takara Tomy	Atlus
Zero D Beat Drop	None	Cyclone Zero	Arc System Works
Yoostar on MTV	None	Yoostar Entertainment Group	Yoostar Entertainment Group
Yo-Ho Kablammo	None	Canalside Studios	Microsoft Game Studios
Xbox Live Arcade Compilation Disc	None	Various	Microsoft Game Studios
Word Puzzle	None	InterServ International	InterServ International
Wits & Wagers	None	Hidden Path Entertainment	Microsoft Game Studios
Wing Commander Arena	None	Gaia Industries	EA Games
Watchmen: The End Is Nigh Parts 1 and 2	None	Deadline Games	Warner Bros. Interactive Entertainment
WarTech: Senko no Ronde	None	G.Rev	Ubisoft
Warlords (2008)	None	Stainless Games	Atari SA
Vigilante 8: Arcade	None	Isopod Labs	Activision
TRON	None	Backbone Entertainment	Disney Interactive Studios
Tomb Raider Underworld: Beneath the Ashes	None	Crystal Dynamics	Eidos Interactive
Ticket to Ride (2008)	None	Next Level Games	Microsoft Game Studios
Things on Wheels	None	Load Inc.	Focus Home Interactive
The Warriors: Street Brawl	None	CXTM	Paramount Digital Entertainment
The Biggest Loser: Ultimate Workout	None	Blitz Games Studios	THQ
Tetris Splash	None	None	Tetris Online, Inc
Tetris Evolution	None	Mass Media	THQ
Tempest	None	Stainless Games	Atari SA
Street Trace: NYC	None	Gaia Industries	Gaia Industries
SpongeBob SquarePants: Underpants Slam!	None	Blitz Arcade	THQ
South Park Let's Go Tower Defense Play!	None	Doublesix	Microsoft Game Studios
Soltrio Solitaire	None	Silver Creek Entertainment	Silver Creek Entertainment
Singularity (Indie Game)	None	Philip C	Philip C
Shred Nebula	None	CrunchTime Games	CrunchTime Games
Shotest Shogi	None	AI Factory	Microsoft Game Studios
Shadow Assault -Tenchu-	None	From Software	From Software
Sega Vintage Collection: Golden Axe	None	M2	Sega
Sea Life Safari	None	Wanako Studios	Sierra Online
Screwjumper!	None	Frozen Codebase	THQ
Schizoid	None	Torpex Games LLC	Microsoft Game Studios
Root Beer Tapper	None	Digital Eclipse	Midway
Rocky and Bullwinkle	None	Zen Studios	Microsoft Game Studios
Raskulls	None	Halfbrick Studios	Halfbrick Studios
Puzzle Arcade	None	Ctxm/Say Design	Eidos Interactive
Portal: Still Alive	None	Valve Software	Microsoft Game Studios
PopCap Arcade Vol 2	None	PopCap	PopCap
Poker Smash (2008)	None	Void Star Creations	Void Star Creations
Pinball FX (2007)	None	Zen Studios	Microsoft Game Studios
Pinball FX 2: Ms. 'Splosion Man	None	Zen Studios	Zen Studios
Over G Fighters	None	Taito Corporation	Ubisoft
Novadrome	None	Stainless Games	Buena Vista Games
Nin2-Jump	None	Cave	Cave
NCAA Basketball 09: March Madness Edition	None	EA Canada	Electronic Arts
Naval Assault: The Killing Tide	None	Artech Studios	505 Games
Naruto: The Broken Bond	None	Ubisoft Montreal	Ubisoft
Mutant Storm Empire	None	PomPom Games	PomPom Games
Mr. Driller Online	None	Namco Bandai Games	Namco Bandai Games
MotionSports	None	Ubisoft Milan	Ubisoft
MLB Stickball	None	Gaia Industries	2K Sports
Mini Ninjas Adventures	None	Side Kick LTD	Square Enix
Minesweeper Flags	None	TikGames	Microsoft Game Studios
Meteos Wars	None	Q Entertainment	Q Entertainment
Lumines Live!	None	Q Entertainment	Q Entertainment
Lost Cities (2008)	None	Sierra Online Shanghai	Sierra Online
Lips: Party Classics	None	iNiS	Microsoft Game Studios
Leedmees	None	Konami	Konami
Kinect Nat Geo TV	None	Relentless Software	Microsoft Game Studios
Kengo: Legend of the 9	None	Genki	Majesco
Infernal: Hell's Vengeance	None	Metropolis Software	Playlogic
Hybrid (2012)	None	5TH Cell	Microsoft Game Studios
Hasbro Family Game Night: Yahtzee	None	Electronic Arts	Electronic Arts
Hasbro Family Game Night: Sorry! Sliders	None	Electronic Arts	Electronic Arts
Hasbro Family Game Night: Sorry!	None	Electronic Arts	Electronic Arts
Hasbro Family Game Night: Scrabble	None	Electronic Arts	Electronic Arts
Hasbro Family Game Night: Connect Four	None	Electronic Arts	Electronic Arts
Hasbro Family Game Night: Boggle	None	Electronic Arts	Electronic Arts
Hasbro Family Game Night: Battleship	None	Electronic Arts	Electronic Arts
Halo: Reach - Noble Map Pack	None	Bungie	Microsoft Game Studios
Halo: Reach - Anniversary Map Pack	None	343 Industries	Microsoft Game Studios
Halo: Origins Bundle	None	Various	Microsoft Game Studios
Halo 4: Majestic Map Pack	None	343 Industries	Microsoft Game Studios
Halo 4: Crimson Map Pack	None	343 Industries	Microsoft Game Studios
Halo 4: Castle Map Pack	None	Certain Affinity	Microsoft Game Studios
Halo 3 Mythic Map Pack II	None	Bungie	Microsoft Game Studios
Halo 3 Mythic Map Pack	None	Bungie	Microsoft Game Studios
Halo 3 Legendary Map Pack	None	Bungie	Microsoft Game Studios
Gyruss	None	Digital Eclipse	Konami
Guardian Heroes	None	Treasure	Sega
Golf: Tee It Up!	None	Housemarque	Activision
Go! Go! Break Steady	None	Little Boy Games	Microsoft Game Studios
Gin Rummy (2008)	None	Sierra Online Shanghai	Sierra Online
GEON: emotions	None	Strawdog Studios	Eidos Interactive
Gel: Set & Match	None	Gastronaut Studios	Gastronaut Studios
Gears of War Triple Pack	None	Epic Games	Microsoft Game Studios
Gears of War 3: Versus Booster Map Pack	None	Epic Games	Microsoft Game Studios
Gears of War 3: Horde Command Pack	None	Epic Games	Microsoft Game Studios
Gears of War 2: Game of the Year Edition	None	Epic Games	Microsoft Game Studios
Game Party: In Motion	None	Farsight Studios	Warner Bros. Interactive Entertainment
Galaga Legions	None	Namco Bandai Games	Namco Bandai Games
Fusion: Genesis	None	Starfire Studios	Microsoft Game Studios
FunTown Mahjong	None	FunTown World Limited	Microsoft Game Studios
Frogger 2	None	Voltex, Inc.	Konami
Forza Horizon: 1000 Club	None	Turn 10	Microsoft Game Studios
Football Genius - The Ultimate Quiz	None	RTL	RTL
Fantastic Pets	None	Blitz Games Studios	THQ
Fable II: Game of the Year Edition	None	Lionhead Studios	Microsoft Game Studios
Encleverment Experiment	None	Blitz Arcade	Blitz Arcade
Easy Golf: Course Architect	None	BarkersCrest Studios	BarkersCrest Studios
DreamWorks Shrek-N-Roll	None	Backbone Entertainment	Activision
Double Dragon II: Wander of the Dragons	None	Gravity	CFK
Doritos Crash Course 2	None	Behaviour Interactive	Microsoft Game Studios
Domino Master	None	TikGames	Microsoft Game Studios
Discs of Tron	None	Backbone Charlottetown	Disney Interactive Studios
Diabolical Pitch	None	Grasshopper Manufacture	Microsoft Game Studios
Death Tank	None	Snowblind Studios	Microsoft Game Studios
Death By Cube	None	Premium Agency 	Square Enix
Dance Paradise	None	Smack Down Productions	THQ
Dance Dance Revolution Universe 3	None	Konami	Konami
Dance Dance Revolution Universe 2	None	Konami	Konami
Dance Dance Revolution Universe	None	Konami	Konami
Cyberball 2072	None	Digital Eclipse	Midway
Crazy Mouse	None	Ultizen Games	Ultizen Games
Commanders: Attack	None	Southend Interactive	Sierra Online
Coffeetime Crosswords	None	Voltex, Inc.	Konami
Chessmaster LIVE	None	Ubisoft Bulgaria	Ubisoft
Centipede & Millipede	None	Stainless Games	Atari SA
Carnival Games: Monkey See, Monkey Do!	None	Take-Two Interactive	Take-Two Interactive
Bust-A-Move Live!	None	Taito Corporation	Taito Corporation
Boom Boom Rocket	None	Bizarre Creations	Electronic Arts
Blue Dragon	None	Mistwalker	Microsoft Game Studios
Blazing Birds	None	Vector 2 Games	Microsoft Game Studios
Beat'n Groovy	None	Voltex, Inc.	Konami
Battlezone (2008)	None	Stainless Games	Atari SA
America's Army: True Soldiers	None	Red Storm Entertainment	Ubisoft
Adrenalin Misfits	None	Konami	Konami
1 vs. 100 (2009)	None	Endemol	Microsoft Game Studios
0 Day Attack on Earth	None	Gulti	Square Enix
