The Legend of Zelda: Ocarina of Time 3D	9.4	GREZZO	Nintendo
Fire Emblem: Awakening	9.2	Intelligent Systems	Nintendo
The Legend of Zelda: A Link Between Worlds	9.1	Nintendo	Nintendo
Super Mario 3D Land	9.0	Nintendo	Nintendo
Pushmo	9.0	Intelligent Systems	Nintendo
Pokemon Y	8.8	Game Freak	Nintendo
Fire Emblem Fates: Special Edition	8.8	Intelligent Systems	Nintendo
Fire Emblem Fates: Revelation	8.8	Intelligent Systems	Nintendo
Animal Crossing: New Leaf	8.8	Nintendo	Nintendo
Yo-kai Watch 2: Psychic Specters	8.7	Level 5	Nintendo
Pokemon X	8.7	Game Freak	Nintendo
Pokemon Sun	8.7	Game Freak	Nintendo
Pokemon Moon	8.7	Game Freak	Nintendo
Monster Hunter 4 Ultimate	8.7	Capcom	Capcom
Metroid: Samus Returns	8.7	Mercury Steam	Nintendo
Kirby: Planet Robobot	8.7	HAL Labs	Nintendo
Kid Icarus: Uprising	8.7	Project Sora	Nintendo
Gotta Protectors (2016)	8.7	Ancient Corp	Ancient Corp
Fire Emblem Fates: Conquest	8.7	Intelligent Systems	Nintendo
Yo-kai Watch 3	8.6	Level 5	Nintendo
Picross 3D: Round 2	8.6	HAL Labs	Nintendo
Luigi's Mansion: Dark Moon	8.6	Next Level Games	Nintendo
Kirby: Triple Deluxe	8.6	HAL Labs	Nintendo
Inazuma Eleven Go: Chrono Stones - Wildfire	8.6	Level 5	Level 5
Fire Emblem Fates: Birthright	8.6	Intelligent Systems	Nintendo
Fire Emblem Echoes: Shadows of Valentia	8.6	Intelligent Systems	Nintendo
Crashmo	8.6	Intelligent Systems	Nintendo
Monster Hunter Generations	8.5	Capcom	Capcom
Mario Kart 7	8.5	Retro Studios	Nintendo
Bravely Default	8.5	Silicon Studio	Nintendo
Stella Glow	8.4	Imageepoch	Atlus
Shin Megami Tensei IV: Apocalypse	8.4	Atlus	Atlus
Shin Megami Tensei: Devil Survivor 2 Record Breaker	8.4	Atlus	Atlus
Pokemon Ultra Moon	8.4	Game Freak	Nintendo
Mario & Luigi: Bowser's Inside Story + Bowser Jr.'s Journey	8.4	Alphadream Corporation	Nintendo
Inazuma Eleven Go: Chrono Stones - Thunderflash	8.4	Level 5	Level 5
Final Fantasy Explorers	8.4	Racjin	Square Enix
Fantasy Life	8.4	Brownie Brown	Nintendo
Etrian Odyssey IV: Legends of the Titan	8.4	Atlus	Atlus
Theatrhythm Final Fantasy: Curtain Call	8.3	indieszero	Square Enix
Stretchmo	8.3	Intelligent Systems	Nintendo
Shin Megami Tensei IV	8.3	Atlus	Atlus
Rhythm Heaven Megamix	8.3	Nintendo	Nintendo
Pokemon Omega Ruby	8.3	Game Freak	Nintendo
Pocket Card Jockey	8.3	Game Freak	Nintendo
Persona Q: Shadow of the Labyrinth	8.3	Atlus	Atlus
Etrian Odyssey Untold: The Millennium Girl	8.3	Atlus	Atlus
BYE-BYE BOXBOY!	8.3	HAL Labs	Nintendo
WarioWare Gold	8.2	Nintendo	Nintendo
Professor Layton VS Phoenix Wright Ace Attorney	8.2	Level 5	Nintendo
Professor Layton and the Miracle Mask	8.2	Level 5	Nintendo
Pokemon Super Mystery Dungeon	8.2	Spike Chunsoft	Nintendo
Pokemon Alpha Sapphire	8.2	Game Freak	Nintendo
Mario & Luigi: Superstar Saga + Bowser's Minions	8.2	Alphadream Corporation	Nintendo
Mario & Luigi: Dream Team	8.2	Alphadream Corporation	Nintendo
Kingdom Hearts 3D: Dream Drop Distance	8.2	Square Enix	Square Enix
Hatsune Miku: Project Mirai DX	8.2	Sega	Sega
Etrian Odyssey 2 Untold: The Fafnir Knight	8.2	Atlus	Atlus
Cave Story 3D	8.2	Nicalis	NIS America
Bravely Second: End Layer	8.2	Silicon Studio	Nintendo
Yo-kai Watch 2: Fleshy Souls	8.1	Level 5	Nintendo
Yo-kai Watch 2: Bony Spirits	8.1	Level 5	Nintendo
Siesta Fiesta	8.1	Mojo Bones	Mojo Bones
Rhythm Thief & the Emperor's Treasure	8.1	Xeen	Sega
Persona Q2: New Cinema Labyrinth	8.1	Atlus	Atlus
Mario Golf: World Tour	8.1	Camelot Software Planning	Nintendo
Ever Oasis	8.1	GREZZO	Nintendo
Etrian Odyssey V: Beyond the Myth	8.1	Atlus	Atlus
Etrian Odyssey Nexus	8.1	Atlus	Atlus
The Denpa Men 3: The Rise of Digitoll	8.1	Genius Sonority Inc.	Genius Sonority Inc.
Dead or Alive Dimensions	8.1	Team Ninja	Tecmo Koei Games
BOXBOY!	8.1	HAL Labs	Nintendo
Art Academy: Lessons for Everyone	8.1	Nintendo	Nintendo
3D After Burner II	8.1	M2	Sega
Style Savvy: Styling Star	8.0	syn Sophia	Nintendo
Shin Megami Tensei: Strange Journey Redux	8.0	Atlus	Atlus
Crimson Shroud	8.0	Nex Entertainment	Level 5
Cooking Mama 5: Bon Appetit!	8.0	Cooking Mama Limited	Majesco
BoxBoxBoy!	8.0	HAL Labs	Nintendo
ZEN Pinball 3D	7.9	Zen Studios	Zen Studios
Tom Clancy's Ghost Recon: Shadow Wars	7.9	Ubisoft	Ubisoft
Nintendo Pocket Football Club	7.9	ParityBit	Nintendo
Mighty Switch Force!	7.9	WayForward	WayForward
Kirby's Extra Epic Yarn	7.9	Good-Feel	Nintendo
Kirby's Adventure	7.9	Arika	Nintendo
Etrian Mystery Dungeon	7.9	Spike Chunsoft	Atlus
Dragon Ball: Fusions	7.9	Ganbarion	Bandai Namco Games
7th Dragon III Code: VFD	7.9	Sega	Sega
Tomodachi Life	7.8	Nintendo	Nintendo
The Denpa Men: They Came By Wave	7.8	Genius Sonority Inc.	Genius Sonority Inc.
The Alliance Alive	7.8	Cattle Call	Atlus
Style Savvy: Fashion Forward	7.8	syn Sophia	Nintendo
Story of Seasons: Trio of Towns	7.8	Marvelous Inc.	XSEED Games
Shin Megami Tensei: Devil Survivor Overclocked	7.8	Atlus	Atlus
New Super Mario Bros. 2	7.8	Nintendo	Nintendo
Marvel Pinball 3D	7.8	Zen Studios	Zen Studios
Mario and Donkey Kong: Minis on the Move	7.8	Nintendo	Nintendo
Harvest Moon 3D: A New Beginning	7.8	Marvelous AQL	Natsume
Hakuoki: Memories of the Shinsengumi	7.8	Idea Factory	Aksys Games
Fluidity: Spin Cycle	7.8	Curve Studios	Nintendo
Code Name: S.T.E.A.M.	7.8	Intelligent Systems	Nintendo
Tappingo 2	7.7	Goodbye Galaxy Games	Goodbye Galaxy Games
Super Little Acorns 3D Turbo	7.7	Pixel Toys	Pixel Toys
Style Savvy: Trendsetters	7.7	syn Sophia	Nintendo
Sega 3D Classics Collection	7.7	M2	Sega
Samurai Warriors Chronicles	7.7	Omega Force	Koei Tecmo Games
Rusty's Real Deal Baseball	7.7	Nintendo	Nintendo
KORG M01D	7.7	Procyon Studio	DETUNE
Kokuga	7.7	G.Rev	G.Rev
Inazuma Eleven Go: Light	7.7	Level 5	Level 5
Fun! Fun! Minigolf TOUCH!	7.7	Shin'en	Shin'en
Freakyforms: Your Creations, Alive!	7.7	Asobism	Nintendo
Dillon's Dead-Heat Breakers	7.7	Vanpool	Nintendo
Attack of the Friday Monsters! A Tokyo Tale	7.7	Millennium Kitchen	Level 5
Yumi's Odd Odyssey	7.6	Studio Saizensen	Natsume
The Denpa Men 2: Beyond The Waves	7.6	Genius Sonority Inc.	Genius Sonority Inc.
Steel Diver: Sub Wars	7.6	Nintendo	Nintendo
Puzzle & Dragons Z + Puzzle & Dragons: Super Mario Bros. Edition	7.6	GungHo	Nintendo
Pokemon Art Academy	7.6	Headstrong Games	Nintendo
Nano Assault EX	7.6	Shin'en	Majesco
Nano Assault	7.6	Shin'en	Majesco
Mario & Luigi: Paper Jam	7.6	Alphadream Corporation	Nintendo
Dillon's Rolling Western	7.6	Vanpool	Nintendo
Culdcept Revolt	7.6	Omiya Soft	NIS America
Chibi-Robo! Photo Finder	7.6	Skip Ltd.	Nintendo
Ridge Racer 3D	7.5	Xeen	Namco Bandai Games
Weapon Shop de Omasse	7.5	Nex Entertainment	Level 5
Paper Mario: Sticker Star	7.5	Intelligent Systems	Nintendo
Nintendogs + Cats: Toy Poodle & New Friends	7.5	Nintendo	Nintendo
Lord of Magna: Maiden Heaven	7.5	Marvelous Inc.	XSEED Games
LBX: Little Battlers eXperience	7.5	Level 5	Nintendo
Inazuma Eleven Go: Shadow	7.5	Level 5	Level 5
Disney Magical World	7.5	h.a.n.d. Inc.	Nintendo
Cooking Mama 4: Kitchen Magic	7.5	Cooking Mama Limited	Majesco
Ultimate NES Remix	7.4	indieszero	Nintendo
Tetris Axis	7.4	Hudson Soft	Nintendo
Shin Megami Tensei: Devil Summoner - Soul Hackers	7.4	Atlus	Atlus
Sakura Samurai: Art of the Sword	7.4	Grounding Inc.	Nintendo
Project X Zone 2	7.4	Monolith Soft	Bandai Namco Games
Project X Zone	7.4	Monolith Soft	Namco Bandai Games
Picross e	7.4	Jupiter Corporation	Jupiter Corporation
HarmoKnight	7.4	Game Freak	Nintendo
Detective Pikachu	7.4	Creatures Inc.	Nintendo
Ace Combat: Assault Horizon Legacy	7.4	Project Aces 	Namco Bandai Games
Yo-kai Watch Blasters: White Dog Squad	7.3	Level 5	Nintendo
Yo-kai Watch Blasters: Red Cat Corps	7.3	Level 5	Nintendo
The Legend of Zelda: Tri Force Heroes	7.3	Nintendo	Nintendo
Shinobi (2011)	7.3	Griptonite Games	Sega
Pokemon Battle Trozei	7.3	Genius Sonority Inc.	Nintendo
Picross e2	7.3	Jupiter Corporation	Jupiter Corporation
Heroes of Ruin	7.3	n-Space	Square Enix
Freakyforms Deluxe: Your Creations, Alive!	7.3	Asobism	Nintendo
Disney Magical World 2	7.3	h.a.n.d. Inc.	Nintendo
Chicken Wiggle	7.3	Atooi LLC	Atooi LLC
Aero Porter	7.3	Vivarium	Level 5
Sonic Boom: Fire & Ice	7.2	Sanzaru Games	Sega
River City: Tokyo Rumble	7.2	Aplus	Natsume
Return to PoPoLoCrois: A Story of Seasons Fairytale	7.2	Marvelous Inc.	XSEED Games
Pilotwings Resort	7.2	Monster Games Inc.	Nintendo
Nintendogs + Cats: Golden Retriever & New Friends	7.2	Nintendo	Nintendo
Nintendogs + Cats: French Bulldog & New Friends	7.2	Nintendo	Nintendo
Mario Sports Superstars	7.2	Camelot Software Planning	Nintendo
Kirby's Blowout Blast	7.2	HAL Labs	Nintendo
Disney Art Academy	7.2	Headstrong Games	Nintendo
Brain Age: Concentration Training	7.2	Nintendo	Nintendo
Senran Kagura Burst	7.1	Tamsoft	XSEED Games
One Piece: Unlimited Cruise SP 2	7.1	Bandai Namco Games	Namco Bandai Games
Naruto Powerful Shippuden	7.1	Inti Creates	Namco Bandai Games
Kirby Battle Royale	7.1	HAL Labs	Nintendo
The Legend of Legacy	7.0	Cattle Call	Atlus
Moon Chronicles: Episode 1	7.0	Renegade Kid	Renegade Kid
Dillon's Rolling Western: The Last Ranger	7.0	Vanpool	Nintendo
Chase: Cold Case Investigations - Distant Memories	7.0	Arc System Works	Aksys Games
The Starship Damrey	6.9	Level 5	Level 5
Pokedex 3D	6.9	Creatures Inc.	Nintendo
Mario Party: Star Rush	6.9	Nd Cube	Nintendo
Hey! Pikmin	6.9	Arzest	Nintendo
Dragon Ball Z: Extreme Butoden	6.9	Arc System Works	Bandai Namco Games
Animal Crossing: Happy Home Designer	6.9	Nintendo	Nintendo
Regular Show: Mordecai and Rigby in 8-Bit Land	6.8	WayForward	D3Publisher
Pokemon Rumble Blast	6.8	Ambrella	Nintendo
One Piece: Unlimited Cruise SP	6.8	Bandai Namco Games	Bandai Namco Games
Gravity Falls: Legend of the Gnome Gemulets	6.8	Ubisoft Osaka	Ubisoft
Urban Trial Freestyle 2	6.7	Teyon	Tate Multimedia
Mahjong Cub3d	6.7	SunSoft	Atlus
Senran Kagura 2: Deep Crimson	6.6	Tamsoft	Marvelous Inc.
Resident Evil: The Mercenaries 3D	6.6	Capcom	Capcom
Pac-Man & Galaga Dimensions	6.6	Namco Bandai Games	Namco Bandai Games
LEGO City Undercover: The Chase Begins	6.6	Traveller's Tales	Nintendo
Kirby Fighters Deluxe	6.6	HAL Labs	Nintendo
Jake Hunter Detective Story: Ghost of the Dusk	6.5	Arc System Works	Aksys Games
Yoshi's New Island	6.4	Arzest	Nintendo
Tekken 3D Prime Edition	6.4	Arika	Namco Bandai Games
Team Kirby Clash Deluxe	6.4	HAL Labs	Nintendo
Tank Troopers	6.4	Nintendo	Nintendo
Spirit Camera: The Cursed Memoir	6.4	Tecmo Koei Games	Nintendo
RPG Maker Fes	6.4	Jupiter Corporation	NIS America
Metroid Prime: Federation Force	6.4	Next Level Games	Nintendo
Dream Trigger 3D	6.4	Art Co., Ltd.	D3Publisher
Pokemon Mystery Dungeon: Gates to Infinity	6.3	Spike Chunsoft	Nintendo
Disney Epic Mickey: The Power of Illusion	6.3	DreamRift	Disney Interactive Studios
Ace Combat: Assault Horizon Legacy+	6.3	Project Aces 	Bandai Namco Games
Sadame	6.2	Mebius	Rising Star Games
Moco Moco Friends	6.2	Racjin	Aksys Games
Bird Mania 3D	6.2	Teyon	Teyon
Steel Diver	6.1	Nintendo	Nintendo
Sonic Boom: Shattered Crystal	6.1	Sanzaru Games	Sega
Pokemon Rumble World	6.1	Ambrella	Nintendo
Mario Party: The Top 100	6.1	Nd Cube	Nintendo
Frogger 3D	6.1	Alpha Unit	Konami
Yu-Gi-Oh! Zexal: World Duel Carnival	6.0	Konami	Konami
Pokemon Dream Radar	5.9	Creatures Inc.	Nintendo
Pokedex 3D Pro	5.9	Creatures Inc.	Nintendo
Mario Party: Island Tour	5.9	Nd Cube	Nintendo
Cubic Ninja	5.9	AQ Interactive	Ubisoft
Chibi-Robo! Zip Lash	5.9	Skip Ltd.	Nintendo
IRONFALL Invasion	5.8	VD-DEV	VD-DEV
DualPenSports	5.8	indieszero	Namco Bandai Games
Fossil Fighters: Frontier	5.7	RED Entertainment	Nintendo
Power Rangers Super Megaforce	5.6	7thChord	Bandai Namco Games
Nintendo Badge Arcade	5.6	Nintendo	Nintendo
Super Monkey Ball 3D	5.5	Sega	Sega
Asphalt 3D	5.4	Gameloft	Ubisoft
Driver: Renegade	5.3	Ubisoft	Ubisoft
Bit Boy!! ARCADE	5.3	Bplus	Bplus
Harvest Moon 3D: The Lost Valley	4.6	Natsume	Natsume
Attack on Titan: Humanity in Chains	4.6	Spike Chunsoft	Atlus
Saban's Power Rangers Megaforce	4.5	Digital Works Entertainment	Namco Bandai Games
Langrisser Re:Incarnation -TENSEI-	4.2	extreme Co.,Ltd.	Aksys Games
BlazBlue: Clonephantasma	4.2	Arc System Works	Arc System Works
RollerCoaster Tycoon 3D	3.9	n-Space	Atari SA
Tenkai Knights: Brave Battle	2.8	Bandai Namco Games	Bandai Namco Games
Zombie Slayer Diox	None	UFO Interactive	UFO Interactive
Zombie Incident	None	CoderChild	CoderChild
Undead Bowling	None	G-STYLE	G-STYLE
Touch Battle Tank 3D	None	SilverStar	Agetec
Tokyo Crash Mobs	None	Mitchell	Nintendo
The Legend of Zelda: Majora's Mask 3D	None	GREZZO	Nintendo
The Legend of Kusakari	None	Librage	Nnooo
The Amazing Spider-Man 2 (2014)	None	Beenox	Activision
Teenage Mutant Ninja Turtles (2014)	None	Magic Pockets	Activision
Tappingo	None	Goodbye Galaxy Games	CIRCLE Entertainment
Tangram Style	None	Moving Player	Moving Player
Swords & Darkness	None	Arc System Works	Arc System Works
Strike Force Foxx	None	Big John Games	Big John Games
StreetPass Mii Plaza	None	Nintendo	Nintendo
Star Fox 64 3D	None	Q-Games	Nintendo
Sssnakes	None	EnjoyUp Games	EnjoyUp Games
SpeedX 3D	None	Gamelion Studios	Gamelion Studios
Sparkle Snapshots 3D	None	Atlus	Nintendo
Skater Cat	None	Fun Unit Inc	Teyon
Silver Falls - 3 Down Stars	None	Sungrand	Sungrand
Shift DX	None	Cosen	Choice Provisions
Samurai Sword Destiny	None	UFO Interactive	UFO Interactive
Samurai G	None	UFO Interactive	UFO Interactive
River City: Knights of Justice	None	Avit-Niigata	Natsume
Rising Board 3D	None	odenis studio	odenis studio
Reel Fishing Paradise 3D	None	Natsume	Natsume
Real Heroes: Firefighter 3D	None	Creative Distribution Ltd	GMG Play
Rabbids Rumble	None	Headstrong Games	Ubisoft
Pyramids 2	None	Enjoy Gaming	Enjoy Gaming
Pyramids	None	Visual Impact	Enjoy Gaming
Puzzler Mind Gym 3D	None	Ubisoft	Ubisoft
PUZZLEBOX setup	None	Bplus	Bplus
Professor Layton and the Azran Legacy	None	Level 5	Nintendo
Pokemon Sun and Pokemon Moon Special Demo Version	None	Game Freak	Nintendo
Pokemon Sun and Moon Dual Pack	None	Game Freak	Nintendo
Pokemon Picross	None	Jupiter Corporation	Nintendo
Pokemon Omega Ruby/Alpha Sapphire Double Pack	None	Game Freak	Nintendo
Pokemon Bank	None	Game Freak	Nintendo
Picross e6	None	Jupiter Corporation	Jupiter Corporation
Picross e5	None	Jupiter Corporation	Jupiter Corporation
Picross e4	None	Jupiter Corporation	Jupiter Corporation
Picross e3	None	Jupiter Corporation	Jupiter Corporation
Picdun 2: Witch's Curse	None	Intense	Intense
Phoenix Wright: Ace Attorney - Dual Destinies - Turnabout Reclaimed	None	Capcom	Capcom
Cube Tactics	None	Fun Unit Inc	Teyon
Pazuru	None	Moragami	Joindots
Nintendo Video	None	Nintendo	Nintendo
Nintendo 3DS	None	Nintendo	Nintendo
Ninja Usagimaru: The Mysterious Karakuri Castle	None	Arc System Works	Aksys Games
Ninja Usagimaru: The Gem of Blessings	None	Arc System Works	Arc System Works
Nikoli's Pencil Puzzle	None	NATSUME ATARI Inc.	Konami
New Super Mario Bros. 2: Platform Panic Pack	None	Nintendo	Nintendo
New Super Mario Bros. 2: Mystery Adventure Pack	None	Nintendo	Nintendo
New Super Mario Bros. 2: Impossible Pack	None	Nintendo	Nintendo
New Super Mario Bros. 2: Gold Mushroom Pack	None	Nintendo	Nintendo
New Super Mario Bros. 2: Coin Challenge Pack C	None	Nintendo	Nintendo
New Super Mario Bros. 2: Coin Challenge Pack A	None	Nintendo	Nintendo
Naruto Shippuden: The New Era	None	Takara Tomy	Takara Tomy
My Nintendo Picross - The Legend of Zelda: Twilight Princess	None	Nintendo	Nintendo
Monster Combine TD	None	Collavier	Collavier
Mii Maker	None	Nintendo	Nintendo
Metroid Prime: Blast Ball	None	Next Level Games	Nintendo
Mario Tennis Open	None	Camelot Software Planning	Nintendo
Madden NFL Football	None	EA Tiburon	Electronic Arts
Lifespeed	None	Wee Man Studios	Wee Man Studios
Let's Golf 3D	None	Gameloft	Gameloft
Ketzal's Corridors	None	Keys Factory	Nintendo
Kersploosh!	None	Poisoft	Nintendo
Karous: The Beast of Re:Eden	None	RS34	CIRCLE Entertainment
Johnny's Payday Panic	None	Office Create	Office Create
Johnny Kung Fu	None	UFO Interactive	UFO Interactive
Johnny Impossible	None	UFO Interactive	UFO Interactive
Johnny Hotshot	None	UFO Interactive	UFO Interactive
Jett Rocket II: The Wrath of Taikai	None	Shin'en	Shin'en
Iron Combat: War in the Air	None	AMZY	Teyon
Smash Cat Heroes	None	Tom Create	Tom Create
Hazumi	None	EyeCancer	Gamelion Studios
Harvest Moon: Skytree Village	None	Natsume	Natsume
Groove Heaven	None	Teyon	Teyon
Gotcha Racing	None	Arc System Works	Natsume
Go! Go! Kokopolo 3D: Space Recipe for Disaster	None	Tanukii Studios	CIRCLE Entertainment
Gardening Mama 2: Forest Friends	None	Racjin	Majesco
Gabrielle's Ghostly Groove 3D	None	Santa Entertainment	Natsume
Flipnote Studio 3D	None	Nintendo	Nintendo
Fire Emblem: Awakening - Apotheosis	None	Intelligent Systems	Nintendo
Family Tennis 3D	None	Arc System Works	Arc System Works
Fairune 2	None	Skipmore	CIRCLE Entertainment
Face Raiders	None	HAL Labs	Nintendo
Excave III: Tower of Destiny	None	Mechanic Arms	Bergsala-Lightweight
Excave II: Wizard of the Underworld	None	Mechanic Arms	Bergsala-Lightweight
Excave	None	Mechanic Arms	Teyon
Dress to Play: Cute Witches!	None	CoderChild	EnjoyUp Games
Dr. Mario: Miracle Cure	None	Nintendo	Nintendo
Doctor Lautrec and the Forgotten Knights	None	WinkySoft	Konami
Digger Dan DX	None	Four Horses	Four Horses
Dedede's Drum Dash Deluxe	None	HAL Labs	Nintendo
Deca Sports Extreme	None	Hudson Soft	Konami
Cut the Rope: Triple Treat	None	FUN Labs	Activision
Cube Creator 3D	None	Gamers Digital	Big John Games
Crash City Mayhem	None	Climax Entertainment	Majesco
Cooking Mama: Sweet Shop	None	Office Create	Rising Star Games
Comic Workshop 2	None	Collavier	Collavier
Comic Workshop	None	Collavier	Collavier
Cocoro: Line Defender	None	Moving Player	Moving Player
Coaster Creator 3D	None	Gamers Digital	Big John Games
Bust-A-Move Universe	None	Arika	Square Enix
Bugs vs. Tanks!	None	NATSUME ATARI Inc.	Level 5
Boulder Dash-XL 3D	None	Catnip Games	Giant Media Group
Bloody Vampire	None	SilverStar	Agetec
Block Factory	None	Enjoy Gaming	Enjoy Gaming
Bike Rider DX2: Galaxy	None	Mobile & Game Studio	Spicysoft Corp.
Beyblade: Evolution	None	SIMS	Rising Star Games
ATV Wild Ride 3D	None	Renegade Kid	Renegade Kid
AR Games	None	Nintendo	Nintendo
Animal Crossing: New Leaf - Welcome Amiibo	None	Nintendo	Nintendo
Alien Chaos 3D	None	Ludosity Interactive	Giant Media Group
AiRace Xeno	None	QubicGames	QubicGames
AiRace Speed	None	QubicGames	QubicGames
A-Train 3D: City Simulator	None	Artdink	Natsume
50 Pinch Barrage!!	None	Mobile & Game Studio	Mobile & Game Studio
2048	None	Cosmigo	Cosmigo
